1111111111111111
1ECCCCCCCCC10001
1CCCCCCCCCC100V1
1CCCCCCCCCC10V01
1CCCCCCCCCC10001
1CCCCCCCCCP100V1
1111111111111111